wwwwwwwwwwwwwwwwwwwwwwwwwwwwwwwwwwwwwwwww
w...w...w...w...w...w...w...w...w...w...w
w...w...w...w...w...w...w...w...w...w...w
w...w...w...w...w...w...w...w...w...w...w
wwdwwwdwwwdwwwdwwwdwwwdwwwdwwwdwwwdwwwdww
w...................w...................w
w.p.................w...................w
wwdwww.wwwdwwwdwwwdwwwdwwwdwwwdwwwdwwwdww
w...................w...................w
w...................w...................w
w.......................................w
wwwwwwwwwwwwwwwwwwwwwwwwwwwwwwwwwwwwwwwww