wwwwwwwwwwwwwwwwwwwww
w...w...w...w...w...w
w...w...w...w...w...w
w...w...w...w...w...w
wwdwwwdwwwdwwwdwwwdww
w...................w
w.p.................w
w...................w
w...................w
w...................w
wwwwwwwwwwwwwwwwwwwww